Geography Type,Year,Geography,Population - Total,Population - Age 0-17,Population - Age 18-29,Population - Age 30-39,Population - Age 40-49,Population - Age 50-59,Population - Age 60-69,Population - Age 70-79,Population - Age 80+,Population - Age 0-4,Population - Age 5-11,Population - Age 12-17,Population - Age 5+,Population - Age 18+,Population - Age 65+,Population - Female,Population - Male,Population - Latinx,Population - Asian Non-Latinx,Population - Black Non-Latinx,Population - White Non-Latinx,Population - Other Race Non-Latinx,Record ID
Citywide,2018,Chicago,2705988,548999,552935,456321,336457,312965,262991,155334,79986,168114,204152,175475,2537874,2156989,349712,1386113,1319875,776661,179841,784266,899980,119467,Citywide-Chicago-2018
ZIP Code,2018,60601,14675,820,4606,2792,2190,1333,1340,1272,322,550,,,14125,13855,2075,7484,7191,1274,,,9677,,ZIP_Code-60601-2018
ZIP Code,2018,60602,1244,149,435,462,135,53,10,0,0,61,,,1183,1095,5,551,693,81,,,788,,ZIP_Code-60602-2018
ZIP Code,2018,60603,1174,56,561,101,97,197,97,65,0,13,,,1161,1118,112,601,573,115,,,707,,ZIP_Code-60603-2018
ZIP Code,2018,60604,782,38,303,104,51,101,130,50,5,12,,,770,744,93,413,369,34,,,479,,ZIP_Code-60604-2018
ZIP Code,2018,60605,27519,2260,8103,6316,3567,3344,2455,1204,270,837,,,26682,25259,2569,14381,13138,1608,,,15781,,ZIP_Code-60605-2018
ZIP Code,2018,60606,3101,101,750,861,465,321,514,89,0,57,,,3044,3000,431,1599,1502,195,,,2129,,ZIP_Code-60606-2018
ZIP Code,2018,60607,29591,3350,11384,7522,3048,1981,1321,632,353,1660,,,27931,26241,1604,14867,14724,2457,,,15440,,ZIP_Code-60607-2018
ZIP Code,2018,60608,79205,14910,20255,14382,10013,8234,6440,3119,1852,4186,,,75019,64295,7852,35360,43845,40146,,,15148,,ZIP_Code-60608-2018
ZIP Code,2018,60609,61495,16600,12450,8451,7324,7061,5176,3378,1055,4820,,,56675,44895,6977,31225,30270,32860,,,9172,,ZIP_Code-60609-2018
ZIP Code,2018,60610,39019,3565,11398,8786,3667,3369,4242,2939,1053,1845,,,37174,35454,6029,21145,17874,2601,,,26809,,ZIP_Code-60610-2018
ZIP Code,2018,60611,32426,1638,7544,7215,2478,3937,4785,3267,1562,892,,,31534,30788,7079,17219,15207,1701,,,23167,,ZIP_Code-60611-2018
ZIP Code,2018,60612,34311,8160,7877,5806,4012,3889,2746,1209,612,2385,,,31926,26151,3136,17631,16680,4206,,,7334,,ZIP_Code-60612-2018
ZIP Code,2018,60613,50113,5793,14643,12674,5748,4958,3187,1880,1230,2555,,,47558,44320,4429,24908,25205,5662,,,36600,,ZIP_Code-60613-2018
ZIP Code,2018,60614,71308,9924,24906,14595,7345,5770,4930,2536,1302,3908,,,67400,61384,6179,35363,35945,4317,,,56762,,ZIP_Code-60614-2018
ZIP Code,2018,60615,41563,6673,11046,6725,4549,4288,4323,2506,1453,2006,,,39557,34890,6022,22423,19140,2573,,,10984,,ZIP_Code-60615-2018
ZIP Code,2018,60616,54464,8215,11692,9486,6755,6620,6221,3303,2172,2457,,,52007,46249,8683,28657,25807,4600,,,13160,,ZIP_Code-60616-2018
ZIP Code,2018,60617,82534,21337,14040,8927,10660,10625,7611,5733,3601,5105,,,77429,61197,12791,44374,38160,31079,,,5215,,ZIP_Code-60617-2018
ZIP Code,2018,60618,94395,20478,16967,19950,14365,10161,6948,3432,2094,6916,,,87479,73917,8526,46244,48151,38152,,,45553,,ZIP_Code-60618-2018
ZIP Code,2018,60619,61258,13004,9237,7612,6708,9315,8378,3953,3051,3911,,,57347,48254,10410,33577,27681,869,,,854,,ZIP_Code-60619-2018
ZIP Code,2018,60620,68096,14684,11375,7287,8437,10136,7482,5062,3633,3563,,,64533,53412,11842,38095,30001,911,,,755,,ZIP_Code-60620-2018
ZIP Code,2018,60621,29042,7810,5183,3250,2926,4073,2897,1739,1164,2504,,,26538,21232,3928,15858,13184,1061,,,320,,ZIP_Code-60621-2018
ZIP Code,2018,60622,52793,8055,14666,15452,6263,3783,2594,1125,855,3540,,,49253,44738,3119,25577,27216,11579,,,34144,,ZIP_Code-60622-2018
ZIP Code,2018,60623,85979,26387,15945,12798,10170,9008,6621,3450,1600,6801,,,79178,59592,7805,44032,41947,56864,,,2508,,ZIP_Code-60623-2018
ZIP Code,2018,60624,36158,11024,6743,4302,4411,4232,2806,1616,1024,3276,,,32882,25134,3922,19252,16906,1915,,,989,,ZIP_Code-60624-2018
ZIP Code,2018,60625,79243,15820,15783,16649,11120,8508,6399,2813,2151,5981,,,73262,63423,7575,39551,39692,25978,,,36086,,ZIP_Code-60625-2018
ZIP Code,2018,60626,49730,8302,12049,9619,6518,5764,4040,2143,1295,2553,,,47177,41428,5031,25148,24582,10252,,,22444,,ZIP_Code-60626-2018
ZIP Code,2018,60628,66724,15513,11827,7029,8502,8953,7216,4984,2700,4153,,,62571,51211,11272,35908,30816,2292,,,1281,,ZIP_Code-60628-2018
ZIP Code,2018,60629,111850,32380,21377,16517,14408,11184,8590,5356,2038,8884,,,102966,79470,11127,57035,54815,79432,,,9203,,ZIP_Code-60629-2018
ZIP Code,2018,60630,57344,11913,7773,8847,7381,8978,6351,3422,2679,3527,,,53817,45431,8738,29455,27889,16007,,,32184,,ZIP_Code-60630-2018
ZIP Code,2018,60631,29529,5985,3662,3896,4358,4127,3549,1897,2055,1875,,,27654,23544,5469,15265,14264,3152,,,24253,,ZIP_Code-60631-2018
ZIP Code,2018,60632,91039,26881,17407,13371,11676,9069,6795,4009,1831,7048,,,83991,64158,8702,44667,46372,76434,,,7996,,ZIP_Code-60632-2018
ZIP Code,2018,60633,12871,2827,2173,1766,1515,2173,1227,765,425,890,,,11981,10044,1676,6085,6786,5790,,,4048,,ZIP_Code-60633-2018
ZIP Code,2018,60634,75995,16581,11044,11242,10440,10766,8425,4638,2859,5026,,,70969,59414,11417,39061,36934,29065,,,41060,,ZIP_Code-60634-2018
ZIP Code,2018,60636,32203,7442,5062,3611,3903,4461,3132,3321,1271,1964,,,30239,24761,6194,16978,15225,2472,,,338,,ZIP_Code-60636-2018
ZIP Code,2018,60637,47454,11552,11606,5984,4834,5367,4549,2253,1309,3182,,,44272,35902,5463,26577,20877,1341,,,6858,,ZIP_Code-60637-2018
ZIP Code,2018,60638,58797,14300,8208,9003,7394,8132,6179,3337,2244,4023,,,54774,44497,8239,29764,29033,30440,,,25612,,ZIP_Code-60638-2018
ZIP Code,2018,60639,90517,24573,16203,13873,12852,10387,7660,3539,1430,6633,,,83884,65944,8137,45508,45009,70538,,,6104,,ZIP_Code-60639-2018
ZIP Code,2018,60640,69715,9545,14152,14142,10576,8963,5970,3574,2793,3256,,,66459,60170,8987,34101,35614,9939,,,38554,,ZIP_Code-60640-2018
ZIP Code,2018,60641,71023,15849,11820,12054,9928,9061,7206,3177,1928,4627,,,66396,55174,7905,36182,34841,38350,,,26008,,ZIP_Code-60641-2018
ZIP Code,2018,60642,20201,2331,6707,5581,2200,1416,1110,585,271,999,,,19202,17870,1322,10092,10109,4074,,,12126,,ZIP_Code-60642-2018
ZIP Code,2018,60643,49870,11082,6126,5627,6451,8105,5905,3706,2868,3134,,,46736,38788,9153,27232,22638,1649,,,10138,,ZIP_Code-60643-2018
ZIP Code,2018,60644,47712,12336,9394,5857,5261,6048,4851,2517,1448,3623,,,44089,35376,6201,25669,22043,3068,,,1392,,ZIP_Code-60644-2018
ZIP Code,2018,60645,47732,12906,7091,6952,5824,5468,5064,2621,1806,4329,,,43403,34826,6564,23992,23740,8127,,,21481,,ZIP_Code-60645-2018
ZIP Code,2018,60646,27987,6000,3377,3458,3787,4086,3238,2108,1933,1802,,,26185,21987,5732,14765,13222,3971,,,20315,,ZIP_Code-60646-2018
ZIP Code,2018,60647,87509,16298,22356,20993,11055,7700,5309,2695,1103,5924,,,81585,71211,6224,43182,44327,39226,,,38809,,ZIP_Code-60647-2018
ZIP Code,2018,60649,46024,10493,7505,6417,5950,5706,5593,2807,1553,3215,,,42809,35531,6570,26852,19172,1183,,,1315,,ZIP_Code-60649-2018
ZIP Code,2018,60651,63218,17329,11457,8910,7649,7391,5787,3359,1336,4780,,,58438,45889,7220,34084,29134,26860,,,2623,,ZIP_Code-60651-2018
ZIP Code,2018,60652,43907,11679,7185,5764,6105,6065,4062,1897,1150,2769,,,41138,32228,4740,23123,20784,17479,,,4472,,ZIP_Code-60652-2018
ZIP Code,2018,60653,31972,8912,4760,4635,4404,3369,3233,1547,1112,2632,,,29340,23060,4122,18269,13703,689,,,1374,,ZIP_Code-60653-2018
ZIP Code,2018,60654,19135,1611,5273,5645,2508,2217,1231,489,161,1164,,,17971,17524,1127,9381,9754,997,,,14124,,ZIP_Code-60654-2018
ZIP Code,2018,60655,28804,7015,4153,3686,3798,4366,3278,1582,926,2026,,,26778,21789,3731,14928,13876,2390,,,23795,,ZIP_Code-60655-2018
ZIP Code,2018,60656,27579,4947,3690,4934,3623,3805,3208,2115,1257,1697,,,25882,22632,4637,13587,13992,3382,,,21053,,ZIP_Code-60656-2018
ZIP Code,2018,60657,70052,8438,23899,17032,7053,5646,4288,2099,1597,3808,,,66244,61614,5618,34638,35414,4901,,,56392,,ZIP_Code-60657-2018
ZIP Code,2018,60659,41068,10154,7449,6165,5198,5372,3730,2043,957,2847,,,38221,30914,4603,20037,21031,7880,,,16363,,ZIP_Code-60659-2018
ZIP Code,2018,60660,43242,5045,10237,8402,5742,5475,4709,2347,1285,1891,,,41351,38197,5741,21705,21537,7728,,,22313,,ZIP_Code-60660-2018
ZIP Code,2018,60661,9926,683,3772,3229,1227,623,369,23,0,447,,,9479,9243,217,4817,5109,640,,,5091,,ZIP_Code-60661-2018
ZIP Code,2018,60666,0,0,0,0,0,0,0,0,0,0,,,0,0,0,0,0,0,,,0,,ZIP_Code-60666-2018
ZIP Code,2018,60707,43019,9285,6546,5958,5818,6006,5111,2582,1713,2292,,,40727,33734,6745,22267,20752,16505,,,20677,,ZIP_Code-60707-2018
ZIP Code,2018,60827,28577,8345,4822,3415,3957,3569,2879,1196,394,2591,,,25986,20232,2763,15666,12911,1222,,,760,,ZIP_Code-60827-2018
Citywide,2019,Chicago,2693959,555424,526788,469300,340219,294864,261009,157790,88565,162797,210448,180859,2531162,2138535,362629,1382528,1311431,776290,184768,768524,901941,62436,Citywide-Chicago-2019
Zip Code,2019,60601,15083,880,5207,2796,2090,970,1733,1154,253,426,237,199,14657,14203,2109,8054,7029,1224,2859,638,9939,423,ZIP_Code-60601-2019
Zip Code,2019,60602,1145,149,207,527,180,66,16,0,0,56,91,0,1089,996,6,506,639,74,245,49,680,97,ZIP_Code-60602-2019
Zip Code,2019,60603,1052,16,498,131,76,174,85,72,0,5,0,11,1047,1036,120,529,523,34,337,34,640,7,ZIP_Code-60603-2019
Zip Code,2019,60604,823,36,325,159,55,91,103,45,9,10,7,19,813,787,72,431,392,28,240,41,514,0,ZIP_Code-60604-2019
Zip Code,2019,60605,29060,2411,8519,7270,3621,3180,2165,1445,449,1047,966,390,28013,26649,2923,15928,13132,2185,4377,4270,16865,1363,ZIP_Code-60605-2019
Zip Code,2019,60606,3287,119,660,1096,483,342,479,108,0,75,44,0,3212,3168,378,1606,1681,188,667,58,2206,168,ZIP_Code-60606-2019
Zip Code,2019,60607,29293,3141,11280,7216,3107,2154,1403,651,341,1317,1257,542,27976,26152,1544,14563,14730,2151,6304,4168,15719,951,ZIP_Code-60607-2019
Zip Code,2019,60608,80059,14812,20455,14507,10292,8176,6705,3266,1846,4318,6021,4449,75741,65247,7939,35599,44460,38984,9914,13326,16955,880,ZIP_Code-60608-2019
Zip Code,2019,60609,60939,15773,12444,8167,7597,6735,5442,3723,1058,4648,6112,4998,56291,45166,7373,30782,30157,32291,3792,15015,9232,609,ZIP_Code-60609-2019
Zip Code,2019,60610,40548,3716,11990,9127,3566,3454,4325,3148,1222,1670,997,1041,38878,36832,6537,21529,19019,2526,3532,5880,27468,1142,ZIP_Code-60610-2019
Zip Code,2019,60611,33224,1856,7778,7168,2693,4066,4806,3344,1513,965,445,446,32259,31368,7142,17716,15508,1573,6156,967,23769,759,ZIP_Code-60611-2019
Zip Code,2019,60612,33735,7837,7330,5921,4020,3695,2842,1363,727,2255,2832,2431,31480,25898,3325,17781,15954,4056,1449,19873,7629,728,ZIP_Code-60612-2019
Zip Code,2019,60613,50761,5885,14036,13315,5534,5059,3409,2080,1443,2726,1981,1178,48035,44876,4904,25108,25653,5645,3491,2985,37074,1566,ZIP_Code-60613-2019
Zip Code,2019,60614,71954,10115,24583,14628,7458,5728,5230,2735,1477,3738,3678,2638,68216,61839,6729,35273,36681,4438,5218,3016,57117,2165,ZIP_Code-60614-2019
Zip Code,2019,60615,40590,6219,10400,6495,4407,4266,4536,2621,1646,2054,2323,1842,38536,34371,6411,22464,18126,2220,3448,21960,11148,1814,ZIP_Code-60615-2019
Zip Code,2019,60616,54197,7829,11557,8634,7107,7319,6256,3243,2252,2095,2782,2923,52102,46368,8636,28388,25809,4569,21379,12694,14418,1137,ZIP_Code-60616-2019
Zip Code,2019,60617,83553,22163,14558,8990,10282,10804,7459,5638,3659,5372,8092,8699,78181,61390,12578,45646,37907,31048,220,46967,4934,384,ZIP_Code-60617-2019
Zip Code,2019,60618,94907,20662,16885,20317,14662,9723,6847,3814,1997,6642,8411,5570,88265,74245,8699,47171,47736,38208,5757,2408,45593,2941,ZIP_Code-60618-2019
Zip Code,2019,60619,61207,12737,9612,7647,6791,9186,8006,4051,3177,3861,4870,4002,57346,48470,10458,33573,27634,804,145,58412,903,943,ZIP_Code-60619-2019
Zip Code,2019,60620,67711,15359,10807,7456,8139,9801,7622,5110,3417,3914,5860,5585,63797,52352,11975,37282,30429,1246,276,64588,847,754,ZIP_Code-60620-2019
Zip Code,2019,60621,28018,7506,4822,3148,2806,3819,3002,1793,1122,2387,2964,2151,25631,20512,3969,14898,13120,891,68,26517,289,253,ZIP_Code-60621-2019
Zip Code,2019,60622,53294,7684,14300,15850,6692,3993,2626,1236,913,3536,2437,1708,49758,45610,3275,25366,27928,12207,2335,3150,34207,1395,ZIP_Code-60622-2019
Zip Code,2019,60623,81283,23403,15040,12147,9672,8570,6534,4516,1401,6073,9735,7595,75210,57880,8645,41033,40250,54297,80,24101,2366,439,ZIP_Code-60623-2019
Zip Code,2019,60624,34892,10189,6449,4158,4122,3967,3369,1585,1053,2839,4268,3074,32053,24703,4038,18344,16548,1773,53,31436,1109,521,ZIP_Code-60624-2019
Zip Code,2019,60625,79444,15998,14847,17078,11236,8505,6608,3005,2167,5762,5896,4285,73682,63446,8057,40178,39266,25483,10658,3599,36289,3415,ZIP_Code-60625-2019
Zip Code,2019,60626,50544,8949,12083,9436,6774,5958,3966,1959,1419,2851,3615,2397,47693,41595,4957,25646,24898,9906,2712,13410,22592,1924,ZIP_Code-60626-2019
Zip Code,2019,60628,64254,14482,11307,7139,7957,8359,7303,4771,2936,3945,5447,5085,60309,49772,11046,34294,29960,2267,135,59478,1333,1041,ZIP_Code-60628-2019
Zip Code,2019,60629,110029,31655,21216,15007,14724,11187,8119,6041,2080,8901,11658,11095,101128,78374,11593,56206,53823,78826,582,21116,8463,1042,ZIP_Code-60629-2019
Zip Code,2019,60630,56433,11266,7717,8800,7969,8263,6654,3340,2424,3111,4526,3621,53322,45167,8687,28985,27448,16066,6177,831,31403,1956,ZIP_Code-60630-2019
Zip Code,2019,60631,29529,5864,3630,4016,3914,4447,3717,1794,2147,2066,2248,1550,27463,23665,5573,15197,14332,3500,1031,269,23763,966,ZIP_Code-60631-2019
Zip Code,2019,60632,89857,25874,17624,12751,11240,9063,6797,4774,1734,6734,10103,9037,83123,63983,9384,43856,46001,74575,6176,1034,7652,420,ZIP_Code-60632-2019
Zip Code,2019,60633,12689,2781,1909,1787,1480,1943,1286,975,528,710,805,1257,11979,9908,2089,6044,6645,6038,0,2955,3654,42,ZIP_Code-60633-2019
Zip Code,2019,60634,75082,16271,10415,11160,10302,10919,8529,4761,2725,4508,6182,5573,70574,58811,11445,38764,36318,28812,4121,1073,40322,754,ZIP_Code-60634-2019
Zip Code,2019,60636,30024,6693,4672,3304,3432,3969,3019,3746,1189,1859,2461,2373,28165,23331,6321,16097,13927,2823,24,26359,441,377,ZIP_Code-60636-2019
Zip Code,2019,60637,47300,11114,11975,5877,4931,5254,4636,2183,1330,3022,4169,3813,44278,36186,5588,26629,20671,1543,2218,35425,6966,1148,ZIP_Code-60637-2019
Zip Code,2019,60638,58669,14545,7924,8989,7264,7874,6506,3398,2169,3884,5542,5119,54785,44124,8240,29443,29226,29543,311,2177,26016,622,ZIP_Code-60638-2019
Zip Code,2019,60639,88204,23036,15550,13440,12571,10179,8034,3780,1614,6161,9273,7600,82043,65168,8698,44143,44061,68792,1124,10828,6628,832,ZIP_Code-60639-2019
Zip Code,2019,60640,69363,9048,14021,15071,10179,8372,6017,3545,3110,2910,3768,2323,66453,60315,9319,33290,36073,9772,7411,11484,38787,1909,ZIP_Code-60640-2019
Zip Code,2019,60641,69880,15420,10959,11809,10150,8899,7444,3286,1913,4385,5936,5075,65495,54460,8121,35575,34305,38120,3208,1429,25014,2109,ZIP_Code-60641-2019
Zip Code,2019,60642,19716,1839,6660,5777,2209,1378,1149,484,220,916,581,342,18800,17877,1175,9427,10289,3202,1427,1962,12534,591,ZIP_Code-60642-2019
Zip Code,2019,60643,48887,10830,5760,5903,5640,7757,6766,3341,2890,2989,3560,4254,45898,38057,9169,26875,22012,1509,139,35352,10446,1441,ZIP_Code-60643-2019
Zip Code,2019,60644,46591,12104,8152,5982,5530,5631,5072,2507,1613,3337,4801,3963,43254,34487,6470,24672,21919,3194,103,41158,1781,355,ZIP_Code-60644-2019
Zip Code,2019,60645,47270,12801,7047,6555,6026,5847,4682,2478,1834,4422,4648,3717,42848,34469,6345,23525,23745,8312,8373,7200,21103,2282,ZIP_Code-60645-2019
Zip Code,2019,60646,28569,6507,3187,3464,3915,3779,3546,2231,1940,1801,2422,2284,26768,22062,5914,15310,13259,4300,2771,286,20625,587,ZIP_Code-60646-2019
Zip Code,2019,60647,87633,15892,22226,21408,11447,7438,5301,2800,1121,5848,5377,4637,81785,71741,6315,43228,44405,37622,3019,4268,40544,2180,ZIP_Code-60647-2019
Zip Code,2019,60649,46633,10399,7662,7040,6036,5582,5548,2849,1517,3122,3913,3359,43511,36234,6723,26590,20043,1189,148,43366,1234,696,ZIP_Code-60649-2019
Zip Code,2019,60651,63492,17077,11299,9175,8027,7257,5959,3196,1502,4563,6594,5906,58929,46415,7500,34216,29276,27245,295,32223,2799,930,ZIP_Code-60651-2019
Zip Code,2019,60652,43447,11360,7017,5397,6166,6133,4153,2034,1187,2695,4731,3933,40752,32087,5061,23006,20441,18027,429,19747,4183,1061,ZIP_Code-60652-2019
Zip Code,2019,60653,33154,9162,5169,4760,4211,3680,3352,1842,978,2902,3319,2923,30252,23992,4239,18812,14342,913,418,29379,1624,820,ZIP_Code-60653-2019
Zip Code,2019,60654,20022,1463,5555,5971,2723,2090,1477,539,204,973,404,86,19049,18559,1330,9979,10043,1156,2851,1070,14365,580,ZIP_Code-60654-2019
Zip Code,2019,60655,28569,7025,4090,3459,3862,4305,3293,1583,952,1922,2689,2414,26647,21544,3648,14627,13942,2586,436,1836,23377,334,ZIP_Code-60655-2019
Zip Code,2019,60656,28218,5241,3628,5206,3587,3756,3230,2244,1326,1878,1902,1461,26340,22977,4968,13796,14422,3768,2372,327,21089,662,ZIP_Code-60656-2019
Zip Code,2019,60657,70958,8951,23709,17072,7136,5847,4529,2158,1556,3875,3048,2028,67083,62007,5702,35306,35652,5385,4887,2085,56603,1998,ZIP_Code-60657-2019
Zip Code,2019,60659,42735,11218,6875,6767,5499,5173,3984,2231,988,3272,4435,3503,39463,31517,5103,21244,21491,8873,11861,3453,16070,2478,ZIP_Code-60659-2019
Zip Code,2019,60660,44498,5361,10768,8716,5623,5616,4552,2422,1440,2009,2166,1138,42489,39137,5942,22027,22471,7614,6000,5937,23247,1700,ZIP_Code-60660-2019
Zip Code,2019,60661,10354,917,3386,3459,1430,658,409,58,37,492,292,133,9862,9437,332,5173,5181,641,2950,429,6027,307,ZIP_Code-60661-2019
ZIP Code,2019,60666,0,0,0,0,0,0,0,0,0,0,0,0,0,0,0,0,0,0,0,0,0,0,ZIP_Code-60666-2019
Zip Code,2019,60707,43093,8982,6752,5495,6005,6181,5269,2826,1583,2331,3726,2925,40762,34111,6979,22556,20537,16862,1533,2981,20783,934,ZIP_Code-60707-2019
Zip Code,2019,60827,28483,8229,5017,3329,4095,3389,2758,1177,489,2578,3115,2530,25905,20254,2859,16017,12466,1486,39,25575,848,535,ZIP_Code-60827-2019
Citywide,2020,Chicago,2699347,552668,548747,463143,336591,313865,255435,145426,83472,165844,207791,177949,2533503,2146679,342174,1388469,1310878,772791,182251,776470,900055,67780,Citywide-Chicago-2020
Zip Code,2020,60601,14513,825,4696,3048,1815,809,1974,1070,276,275,410,120,14238,13688,2605,7894,6619,1242,3528,679,8614,450,ZIP_CODE-60601-2020
Zip Code,2020,60602,1596,115,332,860,191,81,17,0,0,49,66,0,1547,1481,4,744,852,120,435,37,794,210,ZIP_CODE-60602-2020
Zip Code,2020,60603,1186,15,423,248,68,176,146,91,19,3,3,9,1183,1171,198,560,626,62,397,29,692,6,ZIP_CODE-60603-2020
Zip Code,2020,60604,729,5,313,171,30,77,89,36,8,0,0,5,729,724,65,441,288,23,127,72,507,0,ZIP_CODE-60604-2020
Zip Code,2020,60605,30950,2608,8678,8486,3408,3377,2282,1702,409,1359,964,276,29591,28342,3154,16330,14620,2232,5648,4272,17704,1094,ZIP_CODE-60605-2020
Zip Code,2020,60606,3204,96,709,1169,475,373,264,118,0,63,33,0,3141,3108,301,1679,1525,152,1037,50,1835,130,ZIP_CODE-60606-2020
Zip Code,2020,60607,30306,3362,11381,7946,3004,2194,1315,561,543,1679,1100,551,28627,26944,1609,14910,15396,2768,6415,3878,16068,1177,ZIP_CODE-60607-2020
Zip Code,2020,60608,80011,14068,20182,15269,10053,8276,7137,3407,1619,3964,5777,4308,76047,65943,8420,35434,44577,37287,11310,13763,16527,1124,ZIP_CODE-60608-2020
Zip Code,2020,60609,60551,15379,11640,8023,8382,6892,5364,3810,1061,4004,6189,5172,56547,45172,7675,30569,29982,31898,4332,14380,9321,620,ZIP_CODE-60609-2020
Zip Code,2020,60610,40954,3385,12949,8874,3303,3753,4522,2975,1193,1292,1049,1036,39662,37569,6136,21419,19535,2316,4169,5120,27733,1616,ZIP_CODE-60610-2020
Zip Code,2020,60611,33937,2127,8405,6959,3061,4126,4435,3468,1356,1000,641,486,32937,31810,7036,18054,15883,1946,7015,957,23261,758,ZIP_CODE-60611-2020
Zip Code,2020,60612,32240,6760,6933,5287,4255,3855,3051,1393,706,1793,2594,2042,30447,25480,3448,17225,15015,4749,1518,17357,7634,982,ZIP_CODE-60612-2020
Zip Code,2020,60613,51399,6285,14297,13342,5915,4930,3289,2065,1276,2879,2157,1249,48520,45114,4670,26339,25060,6166,3413,3170,36979,1671,ZIP_CODE-60613-2020
Zip Code,2020,60614,72391,10603,24659,14106,7173,6262,5552,2726,1310,3479,4043,3031,68912,61788,6427,36172,36219,4456,5249,2678,57985,2023,ZIP_CODE-60614-2020
Zip Code,2020,60615,41198,6110,11393,6135,4195,4609,4863,2440,1453,2016,2176,1918,39182,35088,6131,22639,18559,2258,3373,21733,11747,2087,ZIP_CODE-60615-2020
Zip Code,2020,60616,52557,7134,11280,8908,6237,7390,6164,2968,2476,2258,2360,2487,50299,45423,8787,27430,25127,4029,20303,12577,14378,1270,ZIP_CODE-60616-2020
Zip Code,2020,60617,82101,20843,13979,9578,10027,10431,8133,5569,3541,4898,7579,8366,77203,61258,13343,45093,37008,31311,194,45210,4830,556,ZIP_CODE-60617-2020
Zip Code,2020,60618,94646,20813,16088,20651,14846,9977,6466,4014,1791,7002,7973,5785,87644,73833,8360,47492,47154,37188,6237,2208,45370,3643,ZIP_CODE-60618-2020
Zip Code,2020,60619,61372,12667,9118,7547,6800,9223,8048,4472,3497,3457,4505,4702,57915,48705,11362,34416,26956,1050,173,58359,613,1177,ZIP_CODE-60619-2020
Zip Code,2020,60620,68761,16203,10753,7954,8243,9215,7759,5081,3553,4177,6390,5636,64584,52558,12360,37732,31029,1680,233,65198,797,853,ZIP_CODE-60620-2020
Zip Code,2020,60621,26736,7157,4311,2784,2662,3654,3236,1580,1352,2442,2644,2064,24294,19579,4145,14588,12148,908,131,24744,389,564,ZIP_CODE-60621-2020
Zip Code,2020,60622,52957,7103,14013,16274,6717,3990,2471,1373,1016,3220,2199,1670,49737,45854,3572,26139,26818,11265,2401,2833,34127,2331,ZIP_CODE-60622-2020
Zip Code,2020,60623,77732,20657,14285,11701,9476,8424,6855,4615,1719,5313,8361,6983,72419,57075,9465,39368,38364,51970,213,22214,2989,346,ZIP_CODE-60623-2020
Zip Code,2020,60624,35054,9336,6757,4366,4094,4253,3516,1640,1092,2729,3849,2748,32325,25718,4204,18277,16777,2589,48,30583,1176,658,ZIP_CODE-60624-2020
Zip Code,2020,60625,78820,15832,14588,17768,10967,8363,6687,2691,1924,5366,5826,4584,73454,62988,7303,40253,38567,25957,9250,3504,36492,3617,ZIP_CODE-60625-2020
Zip Code,2020,60632,86715,23661,17253,12227,10482,9650,6839,4795,1808,6266,9150,8244,80449,63054,9356,41922,44793,71914,5774,936,7721,370,ZIP_CODE-60632-2020
Zip Code,2020,60633,12720,2785,1929,1958,1374,2099,1156,927,492,639,1100,1036,12081,9935,1945,6373,6347,5605,0,3268,3817,30,ZIP_CODE-60633-2020
Zip Code,2020,60634,75604,15430,10876,10909,10921,11400,7989,5382,2697,3927,5624,5871,71677,60174,11221,38951,36653,29667,3881,1441,39825,790,ZIP_CODE-60634-2020
Zip Code,2020,60636,30039,6809,4911,3142,3505,3903,2919,3563,1287,1786,2584,2439,28253,23230,6067,16370,13669,3428,24,25679,395,513,ZIP_CODE-60636-2020
Zip Code,2020,60637,46621,10666,11532,5997,4924,4970,4668,2521,1343,2717,4130,3707,43904,35955,5751,26192,20429,1409,2279,34827,6451,1655,ZIP_CODE-60637-2020
Zip Code,2020,60638,57057,13803,7720,8573,7682,8140,6209,2799,2131,3519,5290,4994,53538,43254,7700,27984,29073,30149,310,1959,24154,485,ZIP_CODE-60638-2020
Zip Code,2020,60639,88515,23270,15119,13086,12292,9829,8491,4421,2007,5868,8876,8523,82647,65245,10149,44344,44171,67494,1232,11718,7144,927,ZIP_CODE-60639-2020
Zip Code,2020,60640,69726,9088,14076,15316,9444,9428,6077,3264,3033,3227,3498,2348,66499,60638,8860,33739,35987,9836,7808,11682,38178,2222,ZIP_CODE-60640-2020
Zip Code,2020,60641,70163,15784,11010,11930,10276,8953,6964,3477,1769,4413,6052,5291,65750,54379,7836,36602,33561,37411,3462,1777,25057,2456,ZIP_CODE-60641-2020
Zip Code,2020,60642,20191,1810,6738,5997,2572,1371,1089,418,196,913,521,376,19278,18381,1074,9968,10223,3450,1708,1916,12346,771,ZIP_CODE-60642-2020
Zip Code,2020,60643,48572,11319,6078,5563,5646,7595,6204,3208,2959,2949,3877,4472,45623,37253,8783,26643,21929,1818,207,34282,10549,1716,ZIP_CODE-60643-2020
Zip Code,2020,60644,45919,11798,7417,5721,5613,5164,5681,2759,1766,3627,4513,3656,42292,34121,6983,24201,21718,4286,148,38773,1840,872,ZIP_CODE-60644-2020
Zip Code,2020,60645,46924,12164,7302,5971,6731,5465,5086,2485,1720,4059,4407,3685,42865,34760,6366,23331,23593,9083,7214,6711,21736,2180,ZIP_CODE-60645-2020
Zip Code,2020,60646,29043,6708,3478,3564,4361,3692,3484,2045,1711,1898,2727,2083,27145,22335,5322,15601,13442,4086,2803,179,21289,686,ZIP_CODE-60646-2020
Zip Code,2020,60647,85658,15040,21614,21752,10871,7195,5272,2445,1469,5618,5127,4267,80040,70618,6254,43046,42612,34024,3394,4039,41547,2654,ZIP_CODE-60647-2020
Zip Code,2020,60649,47084,10038,7796,7125,5897,5588,5941,3113,1586,3362,3578,3097,43722,37046,7304,26070,21014,1261,164,43514,1487,658,ZIP_CODE-60649-2020
Zip Code,2020,60651,63679,16789,11532,9323,7695,7482,5852,3147,1859,3808,6802,6170,59871,46890,7801,34149,29530,25440,181,33762,3183,1113,ZIP_CODE-60651-2020
Zip Code,2020,60652,42296,10768,6875,5147,5950,5941,4444,2077,1094,2596,3904,4267,39700,31528,5100,21753,20543,18354,356,18670,4342,574,ZIP_CODE-60652-2020
Zip Code,2020,60653,33574,8697,5366,4804,3855,3872,3528,2120,1332,2876,3312,2490,30698,24877,4978,19060,14514,1382,468,28717,2097,910,ZIP_CODE-60653-2020
Zip Code,2020,60654,20812,1228,6074,6593,2215,2398,1481,540,283,794,391,43,20018,19584,1460,9951,10861,1598,2637,775,14977,825,ZIP_CODE-60654-2020
Zip Code,2020,60655,27771,6878,3741,3312,3624,4216,3540,1595,865,1793,2597,2488,25978,20893,3847,14296,13475,2537,376,1587,22424,847,ZIP_CODE-60655-2020
Zip Code,2020,60656,28982,5445,3827,5520,3516,3713,3646,2147,1168,1969,2102,1374,27013,23537,5233,14086,14896,3587,2796,950,20907,742,ZIP_CODE-60656-2020
Zip Code,2020,60657,70489,8776,24075,16688,6733,5762,4573,2424,1458,3696,3252,1828,66793,61713,5949,33780,36709,5782,4898,2326,54926,2557,ZIP_CODE-60657-2020
Zip Code,2020,60659,43843,11916,6839,6603,5566,5244,4704,1947,1024,3668,4272,3967,40175,31927,4945,21932,21911,9085,11517,3594,16904,2743,ZIP_CODE-60659-2020
Zip Code,2020,60660,45131,5779,11358,8952,5574,5192,4463,2451,1362,2279,2141,1302,42852,39352,5842,22140,22991,7995,6455,6621,22350,1710,ZIP_CODE-60660-2020
Zip Code,2020,60661,10734,884,3350,3953,1442,658,317,73,57,592,250,42,10142,9850,298,5240,5494,894,2977,307,6209,347,ZIP_CODE-60661-2020
ZIP Code,2020,60666,0,0,0,0,0,0,0,0,0,0,0,0,0,0,0,0,0,0,0,0,0,0,ZIP_CODE-60666-2020
Zip Code,2020,60707,42434,8937,6383,5901,6070,6218,4672,2687,1566,2145,3731,3061,40289,33497,6507,22350,20084,17614,1404,2812,19880,724,ZIP_CODE-60707-2020
Zip Code,2020,60827,28327,8579,4770,3536,3472,3357,2952,1178,483,2699,3187,2686,25628,19748,3023,15709,12618,1861,2,25362,646,456,ZIP_CODE-60827-2020
Citywide,2021,Chicago,2696561,540255,519276,464574,338452,314035,269647,167261,83061,149430,215061,174812,2547131,2156306,373166,1387010,1309551,777744,184263,757971,887130,89453,Citywide-Chicago-2021
Zip Code,2021,60601,14804,999,5065,3739,1390,970,1515,910,216,359,436,184,14445,13805,1963,8260,6544,1234,3827,908,8124,711,ZIP_CODE-60601-2021
Zip Code,2021,60602,1142,119,163,658,67,95,33,7,0,60,59,0,1082,1023,24,540,602,311,101,38,537,155,ZIP_CODE-60602-2021
Zip Code,2021,60603,1275,33,399,266,81,196,191,93,16,12,11,10,1263,1242,224,595,680,78,397,71,723,6,ZIP_CODE-60603-2021
Zip Code,2021,60604,687,6,335,122,38,74,61,33,18,0,0,6,687,681,71,421,266,30,70,72,515,0,ZIP_CODE-60604-2021
Zip Code,2021,60605,32077,2841,9038,8714,3740,3127,2539,1640,438,1196,1174,461,30881,29236,3143,16395,15682,2841,4942,4571,18296,1427,ZIP_CODE-60605-2021
Zip Code,2021,60606,3298,121,790,1202,367,478,184,156,0,75,46,0,3223,3177,256,1567,1731,179,1087,16,1967,49,ZIP_CODE-60606-2021
Zip Code,2021,60607,29990,3300,11585,7356,3360,1967,1289,624,509,1622,1127,515,28368,26690,1594,14801,15189,2743,6690,3717,15534,1306,ZIP_CODE-60607-2021
Zip Code,2021,60608,83689,15392,19489,16442,10590,9000,7655,3393,1728,3924,6462,4994,79765,68297,8837,36923,46766,39476,11486,14042,16943,1742,ZIP_CODE-60608-2021
Zip Code,2021,60609,61861,15202,11900,8011,8603,7565,5743,3821,1016,3888,6090,5212,57973,46659,7772,30963,30898,33408,3924,14573,9140,816,ZIP_CODE-60609-2021
Zip Code,2021,60610,42422,3817,13841,8534,3536,4139,4285,2945,1325,1287,1292,1231,41135,38605,6390,22094,20328,2109,4019,4967,29571,1756,ZIP_CODE-60610-2021
Zip Code,2021,60611,34562,2093,8272,6821,3200,4446,4710,3601,1419,1117,590,386,33445,32469,7339,18203,16359,2232,7076,1077,23254,923,ZIP_CODE-60611-2021
Zip Code,2021,60612,33908,7522,6902,6022,4567,3769,3091,1459,576,1967,2924,2368,31941,26386,3386,17922,15986,5119,1535,18516,7703,1035,ZIP_CODE-60612-2021
Zip Code,2021,60613,53282,6579,14724,13666,5978,5383,3432,2264,1256,2936,2315,1328,50346,46703,4757,26335,26947,6124,4572,3140,37714,1732,ZIP_CODE-60613-2021
Zip Code,2021,60614,72119,10625,23433,14255,7267,6302,5659,3127,1451,3396,4108,3078,68723,61494,7001,35674,36445,4411,5148,2734,57602,2224,ZIP_CODE-60614-2021
Zip Code,2021,60615,41767,6101,11172,6657,4594,4703,4983,2358,1199,1759,2232,2103,40008,35666,5885,22768,18999,2205,3395,22218,11805,2144,ZIP_CODE-60615-2021
Zip Code,2021,60616,53085,7072,10961,9848,5886,7332,6280,3176,2530,2257,2503,2285,50828,46013,8695,27548,25537,3988,19773,12330,15582,1412,ZIP_CODE-60616-2021
Zip Code,2021,60617,84193,21647,13650,10388,10017,10635,8727,5763,3366,5041,7980,8626,79152,62546,13507,46014,38179,33740,171,44794,4880,608,ZIP_CODE-60617-2021
Zip Code,2021,60618,95078,20763,15721,20655,15333,10280,6732,3849,1745,6673,7628,6390,88405,74315,8176,47846,47232,36407,6077,2417,45911,4266,ZIP_CODE-60618-2021
Zip Code,2021,60619,63481,13711,8621,8675,7304,9386,8234,4333,3217,3597,5124,4987,59884,49770,11094,35506,27975,1043,168,60173,607,1490,ZIP_CODE-60619-2021
Zip Code,2021,60620,69357,16375,11103,7892,8218,9119,7917,5087,3646,4566,6255,5554,64791,52982,12580,38240,31117,1937,204,65454,774,988,ZIP_CODE-60620-2021
Zip Code,2021,60621,26538,7066,4325,2919,2744,3611,3047,1585,1241,2069,2730,2257,24469,19472,4039,13937,12601,959,144,24499,398,538,ZIP_CODE-60621-2021
Zip Code,2021,60622,54650,7711,14330,17062,6684,3977,2478,1426,982,3549,2446,1701,51101,46939,3568,27177,27473,11270,2605,3189,35064,2522,ZIP_CODE-60622-2021
Zip Code,2021,60623,77352,20412,14022,11283,9656,8521,6635,4999,1824,5125,8375,6912,72227,56940,9860,39857,37495,51574,263,21992,3002,521,ZIP_CODE-60623-2021
Zip Code,2021,60624,36986,9901,7066,4505,4707,4350,3824,1591,1042,2668,3727,3498,34318,27085,4110,19078,17908,2859,137,32122,1262,606,ZIP_CODE-60624-2021
Zip Code,2021,60625,80028,15667,14404,17535,11247,9346,6949,3029,1851,4751,5979,4797,75277,64361,8047,40506,39522,25898,10121,3780,37163,3066,ZIP_CODE-60625-2021
Zip Code,2021,60632,87395,23015,17076,12882,10088,10607,6700,5277,1750,6159,8628,8227,81236,64380,9802,42553,44842,72204,6020,881,7916,374,ZIP_CODE-60632-2021
Zip Code,2021,60633,12674,2808,2068,1784,1207,2117,1391,792,507,696,1193,909,11978,9866,1926,6467,6207,5271,10,3295,4039,59,ZIP_CODE-60633-2021
Zip Code,2021,60634,77520,15738,10821,10920,11140,12006,8785,5645,2465,3661,5869,6201,73859,61782,11458,40219,37301,31680,4147,1919,38741,1033,ZIP_CODE-60634-2021
Zip Code,2021,60636,30412,6796,4736,3468,3139,3953,3405,3498,1417,2017,2411,2368,28395,23616,6266,15764,14648,4273,49,25213,341,536,ZIP_CODE-60636-2021
Zip Code,2021,60637,49514,11594,12076,5686,5685,5273,5224,2561,1415,2670,4530,4278,46844,37920,6060,27240,22274,1377,2503,36352,7374,1908,ZIP_CODE-60637-2021
Zip Code,2021,60638,58959,14291,7806,9061,8027,8239,6491,2894,2150,3653,5613,5025,55306,44668,8057,28947,30012,32605,384,1583,23996,391,ZIP_CODE-60638-2021
Zip Code,2021,60639,89037,23367,14895,13204,12078,9824,8980,4439,2250,5889,8890,8587,83148,65670,10528,45013,44024,66456,1772,11773,8026,1010,ZIP_CODE-60639-2021
Zip Code,2021,60640,67936,8275,14058,14701,9720,9101,5610,3493,2978,3011,3162,2087,64925,59661,8976,32418,35518,9246,7216,11301,37673,2500,ZIP_CODE-60640-2021
Zip Code,2021,60641,71003,16177,10483,12180,10340,9095,7209,3626,1893,4432,6361,5346,66571,54826,8030,36504,34499,38552,3487,1694,25142,2128,ZIP_CODE-60641-2021
Zip Code,2021,60642,21374,1884,7010,6681,2697,1258,1258,399,187,996,503,385,20378,19490,1155,10672,10702,3406,1583,2021,13545,819,ZIP_CODE-60642-2021
Zip Code,2021,60643,49796,11440,6035,5723,6039,7664,6678,3271,2946,2802,4116,4491,46994,38356,8986,26963,22833,1817,292,35528,10557,1602,ZIP_CODE-60643-2021
Zip Code,2021,60644,47630,12279,7590,5998,6242,5407,5697,3011,1406,3357,5033,3887,44273,35351,6798,25600,22030,4335,303,40264,1811,917,ZIP_CODE-60644-2021
Zip Code,2021,60645,48585,13057,7196,6388,6782,5537,5457,2663,1505,4211,4918,3918,44374,35528,6744,24038,24547,10050,7216,7263,21537,2519,ZIP_CODE-60645-2021
Zip Code,2021,60646,29326,7002,3256,3810,4221,3711,3288,2280,1758,2014,2668,2320,27312,22324,5361,15857,13469,4113,3259,198,20895,861,ZIP_CODE-60646-2021
Zip Code,2021,60647,85564,14620,20816,22494,10556,7690,5404,2522,1462,5488,5247,3860,80076,70944,6319,42804,42760,32028,3596,4961,42071,2908,ZIP_CODE-60647-2021
Zip Code,2021,60649,48973,10532,7859,7993,5542,5755,6692,2991,1609,3375,4157,3000,45598,38441,7360,26516,22457,1409,294,45258,1394,618,ZIP_CODE-60649-2021
Zip Code,2021,60651,64638,16307,11658,9381,8423,7136,6552,3379,1802,3826,6323,6152,60812,48331,8123,34297,30341,25519,161,34288,3583,1087,ZIP_CODE-60651-2021
Zip Code,2021,60652,43485,11059,6951,5594,6664,5503,4559,2048,1107,2282,4342,4434,41203,32426,5265,22212,21273,20528,358,18340,3615,644,ZIP_CODE-60652-2021
Zip Code,2021,60653,34519,8652,5294,4731,4096,4416,3959,2055,1316,2726,3055,2849,31793,25867,5161,20148,14371,1593,440,29390,2172,924,ZIP_CODE-60653-2021
Zip Code,2021,60654,21859,926,7081,6891,2052,2412,1634,615,248,484,364,78,21375,20933,1672,10783,11076,1835,2671,898,15525,930,ZIP_CODE-60654-2021
Zip Code,2021,60655,28751,7061,3795,3295,4013,4273,3559,1809,946,1619,2945,2497,27132,21690,4197,14472,14279,2691,411,1498,23305,846,ZIP_CODE-60655-2021
Zip Code,2021,60656,28665,5489,3538,5182,3847,3713,3727,2030,1139,1865,2065,1559,26800,23176,5064,13832,14833,3647,3241,1034,20027,716,ZIP_CODE-60656-2021
Zip Code,2021,60657,72113,9371,23860,17192,7404,5857,4513,2517,1399,4060,3341,1970,68053,62742,5948,34485,37628,6393,4688,2648,55384,3000,ZIP_CODE-60657-2021
Zip Code,2021,60659,43729,11751,6546,6087,5544,5914,4722,1941,1224,3394,4027,4320,40335,31978,5117,22259,21470,10484,11678,3678,15716,2173,ZIP_CODE-60659-2021
Zip Code,2021,60660,44972,5918,10937,9113,5752,4907,4343,2733,1269,2396,2288,1184,42576,39054,6121,22182,22790,7934,6118,6411,22391,2118,ZIP_CODE-60660-2021
Zip Code,2021,60661,11073,870,3293,4199,1510,726,308,109,58,529,293,48,10544,10203,318,5369,5704,910,3177,262,6388,336,ZIP_CODE-60661-2021
ZIP Code,2021,60666,0,0,0,0,0,0,0,0,0,0,0,0,0,0,0,0,0,0,0,0,0,0,ZIP_CODE-60666-2021
Zip Code,2021,60707,41309,8672,5879,5966,5835,5481,4876,3055,1545,2030,3558,3084,39279,32637,6874,21941,19368,16839,1491,2796,19405,778,ZIP_CODE-60707-2021
Zip Code,2021,60827,26010,8279,4338,3268,3208,2792,2673,1039,413,2374,3184,2714,23636,17731,2656,14285,11725,1764,3,23328,416,499,ZIP_CODE-60827-2021
Zip Code,2021,60626,50295,8007,11937,8965,6995,6738,4360,2178,1115,2810,2977,2165,47485,42288,5098,25318,24977,9694,2724,12646,23029,2202,ZIP_CODE-60626-2021
Zip Code,2021,60628,64489,13734,11638,7491,7593,9066,6930,4860,3177,3557,5498,4657,60932,50755,10940,34961,29528,2775,79,59168,1462,1005,ZIP_CODE-60628-2021
Zip Code,2021,60629,107487,29283,20690,13227,14954,11096,8187,7688,2362,8267,10786,10229,99220,78204,13746,53753,53734,79111,595,18878,7650,1253,ZIP_CODE-60629-2021
Zip Code,2021,60630,55591,11093,7053,8926,7337,7479,7975,3605,2123,3238,4359,3490,52353,44498,9658,27787,27804,14180,7122,1007,31325,1957,ZIP_CODE-60630-2021
Zip Code,2021,60631,30589,6925,3308,4357,3813,4657,3686,1846,1997,2342,2663,1920,28247,23664,5546,15516,15073,4491,1262,307,23360,1169,ZIP_CODE-60631-2021
